"%%%%%%%%%%%%%%%%%%%%"
"%##################%"
"%#####%############%"
"%##################%"
"%###########%######%"
"%##################%"
"%##################%"
"%#####%############%"
"%#############%####%"
"%##################%"
"%##%###############%"
"%##################%"
"%#############%####%"
"%##################%"
"%####%#############%"
"%##################%"
"%###########%######%"
"%##################%"
"%##################%"
"%%%%%%%%%%%%%%%%%%%%";
